_ _ _ _ _ _ _ _ _ _ _ _ _ _ _0
_ _ _ _ _ _ _ _ _ _ _ _ _ _ _0
_ _ _ _ w2_ _ _ _ _ _ _ _ _ _0
_ _ _ _ w2_ _ _ _ _ _ _ _ _ _0
_ _ _ _ w2_ _ _ _ _ _ _ c _ _0
_ _ _ _ w w w w w _ _ _ c _ _0
_ _ _ _ _ _ _ _ _ _ _ _ c _ _0
_ _ _ _ _ _ _ _ _ _ _ _ _ _ _0
_ _ _ d0_ _ _ _ _ _ _ _ _ _ _0
_ _ _ _ _ _ _ _ w w w _ _ _ _0
_ _ _ _ _ _ _ _ w w w _ _ _ _0
_ _ p _ _ _ _ _ _ _ _ _ _ _ _0
_ _ _ _ _ _ _ _ _ _ _ _ _ _ _0
_ _ _ _ _ _ _ c _ _ _ _ c _ _0
_ _ _ _ _ _ _ _ _ _ _ _ _ _ _0