_ _ _ _ _ _ _ _ _ _ _ _ _ _ _0
_ w2w2w2w2w2w2w2w2w2w2w2w2w _0
_ w i _ _ _ _ _ _ _ _ _ _ w _0
_ w _ _ _ _ _ _ _ _ _ _ _ w _0
_ w _ _ _ _ _ _ _ _ _ _ _ w _0
_ w _ _ _ _ _ _ _ _ _ _ _ w _0
_ w _ _ _ _ _ _ _ _ _ _ i w _0
_ w2w2w2w2w2w2w2w2w2w2w2w2w2_0
_ _ _ _ _ _ _ _ _ _ _ _ _ _ _0
_ _ _ _ w w _ _ _ _ _ w1_ s _0
_ _ _ _ _ _ _ _ w1_ _ _ _ _ _0
c w1_ c c c _ c w1_ c c c c _0
_ _ _ _ _ _ _ _ w1_ _ _ _ _ _0
_ p1_ _ w w _ _ _ _ _ w1_ _ _0
_ _ _ _ _ _ _ _ _ _ _ _ _ _ _0