b1b1b1b1b1b1b1b1b1b1b1b1b1b1b1
_ _ _ _ _ _ _ _ _ _ _ _ _ _ _
_ _ _ _ w _ _ _ _ _ _ _ _ _ _
_ _ _ _ w _ _ _ _ _ _ _ _ _ _
_ _ _ _ w _ _ _ _ _ _ _ _ _ _
_ _ _ _ w w w w w _ _ _ _ _ _
_ _ _ _ _ _ _ _ _ _ _ _ _ _ _
_ _ _ _ _ _ _ _ _ _ _ _ _ _ _
_ _ _ _ _ _ _ _ _ _ _ _ _ _ _
_ _ _ _ _ _ _ _ w w w _ _ _ _
_ _ _ _ _ _ _ _ w w w _ _ _ _
_ _ _ p _ _ _ _ _ _ _ _ _ _ _
_ _ _ _ _ _ _ _ _ _ _ _ _ _ _
_ _ _ _ _ _ _ _ _ _ _ _ _ _ _
_ _ _ _ _ _ _ _ _ _ _ _ _ _ _