_ _ _ _ _ _ _ _ _ _ _ _ _ _ _1
_ _ _ _ _ _ _ _ _ _ _ _ _ _ _1
_ _ _ _ w2_ _ _ _ _ _ _ _ _ _1
_ _ _ _ w2_ _ _ _ _ _ _ _ _ _1
_ _ _ _ w2_ _ _ _ _ _ _ _ _ _1
_ _ _ _ w w w w w _ _ _ _ _ _1
_ _ _ _ _ _ _ _ _ _ _ _ _ _ _1
_ _ _ _ _ _ _ _ _ _ _ _ _ _ _1
_ _ _ _ _ _ _ _ _ _ _ _ _ _ _1
_ _ _ _ _ _ _ _ w w w _ _ _ _1
_ _ _ _ _ _ _ _ w w w _ _ _ _1
_ _ p _ _ _ _ _ _ _ _ _ _ _ _1
_ _ _ _ _ _ _ _ _ _ _ _ _ _ _1
_ _ _ _ _ _ _ _ _ _ _ _ _ _ _1
_ _ _ _ _ _ _ _ _ _ _ _ _ _ _1