_ _ _ _ _ _ _ _ _ _ _ _ _ _ _0
_ w w2w2w2w2w2w2w2w2w2w2w2w _0
_ w i _ _ _ _ _ _ _ _ _ _ w _0
_ w _ _ _ _ _ _ _ _ _ _ _ w _0
_ w _ _ _ _ _ _ _ _ _ _ _ w _0
_ w _ _ _ _ _ _ _ _ _ _ _ w _0
_ w _ _ _ _ _ _ _ _ _ _ i w _0
_ w2w2w2w2w2w2w2w2w2w2w2w2w2_0
_ _ _ _ _ _ _ _ _ _ _ _ _ _ _0
_ _ _ _ c c _ _ _ _ _ c _ _ _0
_ _ _ _ _ _ _ _ c _ _ _ _ _ _0
_ c _ s _ _ _ _ c _ _ _ _ s _0
_ _ _ _ _ _ _ _ c _ _ _ _ _ _0
_ p1_ _ c c _ _ _ _ _ c _ _ _0
_ _ _ _ _ _ _ _ _ _ _ _ _ _ _0