_ _ _ _ _ _ _ _ _ _ _ _ _ _ _0
_ w w2w2w2w2w2w2w2w2w2w2w2w _0
_ w _ _ _ _ _ _ _ _ _ _ _ w _0
_ w _ c c _ _ _ _ c _ c _ w _0
_ w _ _ _ _ _ _ _ _ _ c _ w _0
_ w _ _ c _ c _ _ _ c _ _ w _0
_ w _ _ _ _ _ _ _ _ _ _ _ w _0
_ w2w2w2w2w2w2_ w2w2w2w2w2w2_0
_ _ _ _ _ _ _ _ _ _ _ _ _ _ _0
_ _ _ _ _ _ _ _ _ _ _ _ _ _ _0
_ _ _ _ s _ _ _ _ _ _ _ _ _ _0
_ _ _ _ _ _ _ s _ _ _ _ _ _ _0
_ _ _ _ _ _ _ _ _ _ s _ _ _ _0
_ p1_ _ _ _ _ _ _ _ _ _ _ _ _0
_ _ _ _ _ _ _ _ _ _ _ _ _ _ _0