_ _ _ _ _ _ _ _ _ _ _ _ _ _ _ _ _ _ _ _ _ _ _ _ _0
_ _ _ _ _ _ _ c _ w1_ w1_ w1_ w1_ _ _ _ _ _ _ _ _0
_ _ _ _ _ _ _ _ _ _ _ _ _ _ _ _ _ _ _ _ _ _ _ _ _0
_ _ _ _ _ _ _ c _ w1_ w1_ w1_ w1_ _ _ _ _ _ _ _ _0
_ _ _ _ _ _ _ _ _ _ _ _ _ _ _ _ _ _ _ _ _ _ _ _ _0
_ _ _ _ _ _ _ c _ w1_ w1_ w1_ w1_ _ _ _ _ _ _ _ _0
_ _ _ _ _ _ _ _ _ _ _ _ _ _ _ _ _ _ _ _ _ _ _ _ _0
_ _ _ _ _ _ _ c _ w1_ w1_ w1_ w1_ _ _ _ _ _ _ _ _0
_ _ _ _ _ _ _ _ _ _ _ _ _ _ _ _ _ _ _ _ _ _ _ _ _0
_ _ _ _ _ _ _ c _ w1_ w1_ w1_ w1_ _ _ _ _ _ _ _ _0
_ _ _ _ _ _ _ _ _ _ _ _ _ _ _ _ _ _ _ _ _ _ _ _ _0
_ _ _ _ _ _ _ c _ w1_ w1_ w1_ w1_ _ _ _ _ _ _ _ _0
_ _ _ p1_ _ _ _ _ _ _ _ _ _ _ _ _ _ _ _ _ _ _ _ _0
_ _ _ _ _ _ _ c _ w1_ w1_ w1_ w1_ _ _ _ _ _ _ _ _0
_ _ _ _ _ _ _ _ _ _ _ _ _ _ _ _ _ _ _ _ _ _ _ _ _0
_ _ _ _ _ _ _ c _ w1_ w1_ w1_ w1_ _ _ _ _ _ _ _ _0
_ _ _ _ _ _ _ _ _ _ _ _ _ _ _ _ _ _ _ _ _ _ _ _ _0
_ _ _ _ _ _ _ c _ w1_ w1_ w1_ w1_ _ _ _ _ _ _ _ _0
_ _ _ _ _ _ _ _ _ _ _ _ _ _ _ _ _ _ s _ _ _ s _ _0
_ _ _ _ _ _ _ c _ w1_ w1_ w1_ w1_ _ _ _ _ _ _ _ _0
_ _ _ _ _ _ _ _ _ _ _ _ _ _ _ _ _ _ _ _ _ _ _ _ _0
_ _ _ _ _ _ _ c _ w1_ w1_ w1_ w1_ _ _ _ _ _ _ _ _0
_ _ _ _ _ _ _ _ _ _ _ _ _ _ _ _ _ _ s _ _ _ s _ _0
_ _ _ _ _ _ _ c _ w1_ w1_ w1_ w1_ _ _ _ _ _ _ _ _0
_ _ _ _ _ _ _ _ _ _ _ _ _ _ _ _ _ _ _ _ _ _ _ _ _0