_ _ _ _ _ _ _ _ _ _ _ _ _ _ _0
_ s s s s s _ _ _ _ _ _ c d1_0
_ s s s s s _ _ _ _ _ _ _ _ _0
_ s s s s s _ _ _ _ _ _ c d1_0
_ s s s s s _ _ _ _ _ _ _ _ _0
_ _ _ _ _ _ _ _ _ _ _ _ c d1_0
_ _ _ _ _ _ _ _ _ _ _ _ _ _ _0
_ _ d _ _ _ _ _ _ _ _ _ c d1_0
_ d3c d1_ _ _ _ _ _ _ _ _ _ _0
_ _ d2_ _ _ _ _ _ _ _ _ c d1_0
_ _ _ _ _ _ _ _ _ _ _ _ _ _ _0
_ _ d _ _ _ _ _ _ _ _ _ c d1_0
_ d3p1d1_ _ _ _ _ _ _ _ _ _ _0
_ _ d2_ _ _ _ _ _ _ _ _ c d1_0
_ _ _ _ _ _ _ _ _ _ _ _ _ _ _0